R 1000 600
S ./textures/Pac_man/ghost.xpm
NO ./textures/Pac_man/neon_blue.xpm
WE ./textures/Pac_man/neon_magenta.xpm
SO ./textures/Pac_man/neon_green.xpm
EA ./textures/Pac_man/neon_red.xpm

F  10,10,10
C  20,20,20

1111111111111111111
1000000001000000001
1011011101011101101
1011011101011101101
1000000000E00000001
1011010111110101121
1000010001000100001
1111011101011101111
   1000000000001
   1001111111001
   1000000000001
   1010111110101
1111010001000101111
1000000001000000001
1011011101011101121
1001000000000001001
1101010111110101011
1000010001000100001
1211111110111111121
1000000000000000001
1111111111111111111